1111111111111111111111111111111
10000C00111000C1000000000000011
1C111C00001000010001000000C0001
1000000000000000000000000000001
1000C00C00000010111111000101111
1111111111111111110000000C00001
1CCCCCCCC0000000000000000000001
111111111111111111000000000C001
1000000P00000000000001000000001
1000000000010000000001000000001
10000000000100000011110000000E1
1111111111111111111111111111111
