1111111111
100000A001
1P000C0001
1000000E01
1111111111
