1110001111
10000C0001
1P00000001
1000000E01
1111111111
