1111111111
1000C00001
1P00000001
1000000001
1111111111
