1111111111
100000C001
1P00000001
1000000E01
111111111
