1111111111
10C010C001
1P00100001
1000100E01
1111111111
