1111111111
1000000P01
1P00000001
1000000E01
1111111111
